Species	Status
Abavornis_bonaparti	extinct
Aberratiodontus_wui	extinct
Accipiter	extinct
Accipiter_cooperi	extinct
Accipiter_fasciatus	extant
Accipiter_gentilis	extant
Accipiter_nisus	extinct
Accipiter_striatus	extant
Accipitridae	extinct
Accipitrinae	extinct
Actitis_macularia	extinct
Adelalopus	extinct
Aechmophorus	extinct
Aechmophorus_elasson	extinct
Aechmophorus_occidentalis	extinct
Aegialornis_gallicus	extinct
Aegialornis_wetmorei	extinct
Aegialornithidae	extinct
Aegolius	extinct
Aegolius_acadicus	extant
Aegolius_gradyi	extinct
Aegolius_martae	extinct
Aegotheles	extinct
Aegotheles_novaezealandiae	extant
Aegypiinae	extinct
Aegypius	extinct
Aepyornis	extinct
Aepyornithidae	extinct
Aethia	extinct
Aethia_barnesi	extinct
Agelaius	extinct
Agelaius_phoeniceus	extinct
Agriocharis_anza	extinct
Agriocharis_progenes	extinct
Aix_sponsa	extinct
Aizengyps_toomeyae	extinct
Ajaia	extinct
Ajaia_chione	extinct
Alamitornis_minutus	extinct
Alauda	extinct
Alca	extinct
Alca_ausonia	extinct
Alca_carolinensis	extinct
Alca_grandis	extinct
Alca_minor	extinct
Alca_olsoni	extinct
Alca_stewarti	extinct
Alca_torda	extant
Alcidae	extinct
Alcini	extinct
Alethoalaornis_agitornis	extinct
Aletornis_bellus	extinct
Aletornis_gracilis	extinct
Aletornis_nobilis	extinct
Aletornis_pernix	extinct
Aletornis_venustus	extinct
Alexornis_antecedens	extinct
Alexornithidae	extinct
Alle_alle	extant
Ambiortus_dementjevi	extinct
Amitabha_urbsinterdictensis	extinct
Ammodramus	extinct
Amplibuteo_concordatus	extinct
Amplibuteo_hibbardi	extinct
Amplibuteo_woodwardi	extinct
Anabernicula	extinct
Anabernicula_gracilenta	extinct
Anabernicula_oregonensis	extinct
Anas	extinct
Anas_acuta	extant
Anas_americana	extinct
Anas_amotape	extinct
Anas_carolinensis	extinct
Anas_chlorotis	extant
Anas_clypeata	extinct
Anas_crecca	extant
Anas_cyanoptera	extinct
Anas_discors	extinct
Anas_gracilipes	extinct
Anas_itchtucknee	extinct
Anas_kurochkini	extinct
Anas_platyrhynchos	extant
Anas_sanctaehelenae	extinct
Anas_schneideri	extinct
Anas_talarae	extinct
Anatalavis_rex	extinct
Anatidae	extinct
Anatinae	extinct
Anchigyps_voorhiesi	extinct
Andalgalornis	extinct
Andrewsornis	extinct
Anhinga	extinct
Anhinga_anhinga	extinct
Anhinga_grandis	extinct
Anhinga_pannonica	extinct
Anhinga_subvolans	extinct
Anisolornis	extinct
Anomalopteryx_didiformis	extant
Anser	extinct
Anser_albifrons	extant
Anseranas	extinct
Anser_arizonae	extinct
Anser_condoni	extinct
Anseriformes	extinct
Anserinae	extinct
Anserini	extinct
Anthochaera_carunculata	extant
Anthochaera_chrysoptera	extant
Anthornis_melanura	extant
Anthropodyptes_gilli	extinct
Anthropornis	extinct
Anthropornis_grandis	extinct
Anthropornis_nordenskjoeldi	extinct
Apatornis_celer	extinct
Aphelocoma	extinct
Aphelocoma_coerulescens	extinct
Apodidae	extinct
Apsaravis_ukhaana	extinct
Aptenodytes	extinct
Aptenodytes_ridgeni	extinct
Apteribis	extinct
Apteribis_brevis	extant
Apteribis_glenos	extant
Apteryx	extinct
Aptornis	extinct
Aptornis_proasciarostratus	extinct
Apus	extinct
Aquatilavipes	extinct
Aquatilavipes_curriei	extinct
Aquatilavipes_izumiensis	extinct
Aquatilavipes_swiboldae	extinct
Aquila	extinct
Aquila_bivia	extinct
Aquila_chrysaetos	extant
Aquila_pliogryps	extinct
Aquila_sodalis	extinct
Aramidae	extinct
Aramornis_longurio	extinct
Aramus	extinct
Archaeocycnus_lacustris	extinct
Archaeopterygiformes	extinct
Archaeopteryx	extinct
Archaeopteryx_lithographica	extinct
Archaeorhynchus_spathula	extinct
Archaeornithipus_meijidei	extinct
Archaeornithura_meemannae	extinct
Archaeospheniscus	extinct
Archaeospheniscus_lopdelli	extinct
Archaeospheniscus_lowei	extinct
Archaeospheniscus_wimani	extinct
Archaeotrogon_venustus	extinct
Archaeovolans_repatriatus	extinct
Ardea	extinct
Ardea_cinerea	extinct
Ardea_herodias	extant
Ardea_paloccidentalis	extinct
Ardea_polkensis	extinct
Ardeidae	extinct
Ardeola	extinct
Arenaria	extinct
Arenaria_interpres	extinct
Argentavis_magnificens	extinct
Arthrodytes	extinct
Arthrodytes_andrewsi	extinct
Asiahesperornis_bazhanovi	extinct
Asio	extinct
Asio_flammeus	extant
Asio_priscus	extinct
Asturaetus_furcillatus	extinct
Athene	extinct
Athene_veta	extinct
Atlantisia_podarces	extant
Australornis_lovei	extinct
Aves	extinct
Avipedidae	extinct
Avisaurus_archibaldi	extinct
Avisaurus_gloriae	extinct
Aythya	extinct
Aythya_affinis	extinct
Aythya_americana	extinct
Aythya_collaris	extinct
Aythya_marila	extinct
Aythya_valisineria	extinct
Badiostes_patagonicus	extinct
Balaenicipitidae	extinct
Balearica	extinct
Bambolinetta_lignitifila	extinct
Baptornis	extinct
Baptornis_advenus	extinct
Baptornis_varneri	extinct
Baptornithidae	extinct
Barawertornis_tedfordi	extinct
Barrosopus_slobodai	extinct
Bartramia_longicauda	extinct
Bartramia_umatilla	extinct
Bathoceleus_hyphalus	extinct
Bathornis	extinct
Bathornis_celeripes	extinct
Bathornis_fricki	extinct
Bathornis_veredus	extinct
Bauxitornis_mindszentyae	extinct
Baza_gracilis	extinct
Belgirallus	extinct
Belgirallus_minutus	extinct
Belgirallus_oligocaenus	extinct
Belonopterus_edmondi	extinct
Berruornis_halbedeli	extinct
Berruornis_orbisantiqui	extinct
Bohaiornis_guoi	extinct
Boluochia_zhengi	extinct
Bombycilla	extinct
Bonasa	extinct
Bonasa_umbellus	extant
Boreortalis	extinct
Boreortalis_laesslei	extinct
Borvocarbo	extinct
Borvocarbo_tardatus	extinct
Botauroides_parvus	extinct
Botaurus	extinct
Botaurus_lentiginosus	extinct
Boutersemia	extinct
Boutersemia_belgica	extinct
Boutersemia_parvula	extinct
Brachyramphus	extinct
Brachyramphus_dunkeli	extinct
Brachyramphus_pliocenum	extinct
Branta	extinct
Branta_bernicla	extinct
Branta_canadensis	extant
Branta_hylobadistes	extant
Branta_hypsibata	extinct
Branta_propinqua	extinct
Branta_ruficollis	extinct
Branta_woolfendeni	extinct
Breagyps	extinct
Brodavis_americanus	extinct
Brodavis_baileyi	extinct
Brodavis_mongoliensis	extinct
Brontornis_burmeisteri	extinct
Bubo	extinct
Bubo_insularis	extinct
Bubo_sinclairi	extant
Bubo_virginianus	extant
Bucephala	extinct
Bucephala_albeola	extinct
Bucephala_clangula	extinct
Bucephala_ossivallis	extinct
Bucerotidae	extinct
Bullockornis	extinct
Bullockornis_planei	extinct
Bulweria	extinct
Bulweria_bifax	extant
Burhinidae	extinct
Burhinus	extinct
Burhinus_lucorum	extinct
Burhinus_nanus	extinct
Buteo	extinct
Buteo_buteo	extant
Buteo_fluviaticus	extinct
Buteogallus	extinct
Buteogallus_urubitinga	extinct
Buteo_grangeri	extinct
Buteo_jamaicensis	extant
Buteo_lineatus	extinct
Buteoninae	extinct
Buteo_platypterus	extinct
Buteo_rufinus	extinct
Buteo_swainsoni	extinct
Buteo_typhoius	extinct
Butorides_validipes	extinct
Butorides_virescens	extinct
Cacatua_roseicapilla	extant
Cacatua_tenuirostris	extant
Calcardea_junnei	extinct
Calidris	extinct
Calidris_melanotos	extinct
Calidris_pacis	extinct
Callaeas_cinerea	extinct
Callipepla	extinct
Calonectris	extinct
Calonectris_borealis	extinct
Calonectris_diomedea	extinct
Calonectris_krantzi	extinct
Calonectris_kurodai	extinct
Camptodontus_yangi	extinct
Canadaga_arctica	extinct
Capella	extinct
Capella_media	extinct
Caprimulgidae	extinct
Caprimulgus	extinct
Caprimulgus_piurensis	extinct
Caracara	extinct
Caracara_creightoni	extant
Caracara_plancus	extant
Cardinalis_cardinalis	extinct
Carduelis	extinct
Cariama_santacrucensis	extinct
Cariaminae	extinct
Carpodacus	extinct
Caspiodontornis_kobystanicus	extinct
Casuarius	extinct
Catenoleimus_anachoretus	extinct
Catharacta	extinct
Catharista_shastensis	extinct
Cathartes_aura	extant
Cathartes_fossilis	extinct
Cathartidae	extinct
Catharus	extinct
Cathayornis_yandica	extinct
Catoptrophorus_semipalmatus	extinct
Centrornis	extinct
Cepphus	extinct
Cepphus_columba	extant
Cepphus_olsoni	extinct
Ceramornis_major	extinct
Cerebavis_cenomanica	extinct
Cerorhinca	extinct
Cerorhinca_dubia	extinct
Cerorhinca_minor	extinct
Cerorhinca_reai	extinct
Ceryle_torquata	extinct
Chaetoptila	extinct
Chaetura	extinct
Changchengornis_hengdaoziensis	extinct
Changmaornis_houi	extinct
Chaoyangia_beishanensis	extinct
Charadrii	extinct
Charadriiformes	extinct
Charadrius	extinct
Charadrius_bicinctus	extinct
Charadrius_obscurus	extinct
Charadrius_sanctaehelenae	extant
Charadrius_semipalmatus	extinct
Charadrius_vociferus	extinct
Chascacocolius	extinct
Chascacocolius_cacicirostris	extinct
Chelychelynechen_quassus	extant
Chen_caerulescens	extinct
Chendytes	extinct
Chendytes_lawi	extinct
Chen_hyperborea	extinct
Chenonetta_finschi	extant
Chenopis	extinct
Chen_pressa	extinct
Chen_rossii	extinct
Chionoides_australiensis	extinct
Chlidonias	extinct
Chloephaga	extinct
Chondestes_grammacus	extinct
Chunga	extinct
Ciconia	extinct
Ciconia_maltha	extinct
Ciconiidae	extinct
Ciconiiformes	extinct
Cimolopterygidae	extinct
Cimolopteryx	extinct
Cimolopteryx_maxima	extinct
Cimolopteryx_rara	extinct
Cinclosoma_punctatum	extant
Circus	extinct
Ciridops	extinct
Cistothorus	extinct
Cistothorus_brevis	extinct
Cladornis_pachypus	extinct
Clangula	extinct
Cnemiornis_calcitrans	extant
Coccyzus	extinct
Coccyzus_americanus	extinct
Coenocorypha	extinct
Coenocorypha_iredalei	extinct
Colaptes	extinct
Colaptes_auratus	extant
Coliidae	extinct
Colinus	extinct
Colinus_suilium	extinct
Colinus_virginianus	extant
Colius	extinct
Collocalia	extinct
Columba	extinct
Columba_livia	extant
Columbidae	extinct
Columbina	extinct
Colymbiculus_udovichenkoi	extinct
Colymbidae	extinct
Colymboides	extinct
Colymboides_metzleri	extinct
Colymbus	extinct
Colymbus_nigricollis	extant
Colymbus_oligocaenus	extinct
Colymbus_parvus	extinct
Colymbus_portisi	extinct
Colymbus_subparvus	extinct
Concornis_lacustris	extinct
Confuciusornis	extinct
Confuciusornis_chuonzhous	extinct
Confuciusornis_dui	extinct
Confuciusornis_feducciai	extinct
Confuciusornis_jianchangensis	extinct
Confuciusornis_sanctus	extinct
Confuciusornis_suniae	extinct
Contopus	extinct
Contopus_virens	extinct
Conuropsis_fratercula	extinct
Copepteryx_hexeris	extinct
Copepteryx_titan	extinct
Coracii	extinct
Coraciiformes	extinct
Coracopsis	extinct
Coragyps	extinct
Coragyps_atratus	extinct
Corvidae	extinct
Corvus	extinct
Corvus_annectens	extinct
Corvus_brachyrhynchos	extinct
Corvus_corax	extant
Corvus_moriorum	extinct
Corvus_ossifragus	extinct
Corvus_pliocaenus	extinct
Corvus_wetmorei	extinct
Coturnicops	extinct
Coturnix	extinct
Coturnix_novaezelandiae	extant
Coua	extinct
Cracidae	extinct
Cracticidae	extinct
Cratoavis_cearensis	extinct
Cremaster_tytthus	extinct
Crinifer	extinct
Crossvallia_unienwillia	extinct
Cruschedula_revola	extinct
Crypturellus	extinct
Cuculidae	extinct
Cursoricoccyx_geraldinae	extinct
Cyanocitta	extinct
Cyanocitta_cristata	extant
Cyanolanius	extinct
Cyanoramphus	extinct
Cygninae	extinct
Cygnopterus	extinct
Cygnus	extinct
Cygnus_atratus	extinct
Cygnus_columbianus	extinct
Cygnus_hibbardi	extinct
Cygnus_(Olor)	extinct
Cygnus_paloregonus	extinct
Cyphornis_magnus	extinct
Cyrilavis_olsoni	extinct
Cyrtonyx	extinct
Cyrtonyx_tedfordi	extinct
Dafila	extinct
Dakotornis_cooperi	extinct
Dalingheornis_liweii	extinct
Dapingfangornis	extinct
Dapingfangornis_sentisorhinus	extinct
Dasornis	extinct
Dasornis_abdoun	extinct
Dasornis_emuinus	extinct
Dasyornis	extinct
Dasyornis_brachypterus	extant
Dege_hendeyi	extinct
Delphinornis	extinct
Delphinornis_arctowskii	extinct
Delphinornis_larseni	extinct
Dendragapus	extinct
Dendragapus_gillii	extinct
Dendragapus_obscurus	extant
Dendrochen_robusta	extinct
Dendrocopos	extinct
Dendrocopos_pubescens	extinct
Dendrocygna	extinct
Dendrocygna_arborea	extant
Dendrocygna_autumnalis	extant
Dendrocygninae	extinct
Devincenzia	extinct
Devincenzia_gallinali	extinct
Diatropornis	extinct
Diatryma	extinct
Diatryma_cotei	extinct
Diatryma_gigantea	extinct
Diatrymiformes	extinct
Dinornis	extinct
Dinornis_giganteus	extinct
Dinornis_struthoides	extant
Dinornithidae	extinct
Dinornithiformes	extinct
Diogenornis_fragilis	extinct
Diomedea	extinct
Diomedea_milleri	extinct
Diomedea_thyridata	extinct
Diomedeidae	extinct
Diomedeoides	extinct
Diomedeoides_lipsiensis	extinct
Divisulcus_demerei	extinct
Dorypaltus	extinct
Dorypaltus_prophatus	extinct
Drepanidini	extinct
Dromaius	extinct
Dromaius_novaehollandiae	extinct
Dromaius_ocypus	extinct
Dromornis_stirtoni	extinct
Dromornithidae	extinct
Dryocopus	extinct
Dryornis_pampeanus	extinct
Dumetella_carolinensis	extinct
Dunhuangia_cuii	extinct
Dunstanetta_johnstoneorum	extinct
Duntroonornis_parvus	extinct
Dysmoropelia_dekarchiskos	extinct
Ectopistes_migratorius	extant
Egretta	extinct
Egretta_subfluvia	extinct
Elbretornis	extinct
Elbretornis_bonapartei	extinct
Eleutherornis_helveticus	extinct
Elopteryx_nopcsai	extinct
Elsornis_keni	extinct
Emberizidae	extinct
Emeidae	extinct
Emeus_crassus	extant
Empheresula	extinct
Empheresula_arvernensis	extinct
Emuarius_gidju	extinct
Enaliornis_barretti	extinct
Enaliornis_sedgwicki	extinct
Enantiophoenix_electrophyla	extinct
Enantiornis	extinct
Enantiornis_leali	extinct
Enantiornithes	extinct
Eoalulavis_hoyasi	extinct
Eobucco	extinct
Eobucco_brodkorbi	extinct
Eocathartes_robustus	extinct
Eocathayornis_walkeri	extinct
Eoceornis_ardetta	extinct
Eoconfuciusornis_zhengi	extinct
Eocoracias_brachyptera	extinct
Eocrex_primus	extinct
Eocuculus_cherpinae	extinct
Eocypselus_vincenti	extinct
Eoenantiornis_buhleri	extinct
Eoglaucidium	extinct
Eogruidae	extinct
Eogrus	extinct
Eoneornis_australis	extinct
Eonessa_anaticula	extinct
Eopengornis_martini	extinct
Eopuffinus_kazachstanensis	extinct
Eostega_lebedinskyi	extinct
Eostrix_martinellii	extinct
Eostrix_tsaganica	extinct
Ephippiorhynchus	extinct
Ephippiorhynchus_asiaticus	extinct
Eremochen_russelli	extinct
Eremopezus_eocaenus	extinct
Eremophila_alpestris	extinct
Eretiscus_tonnii	extinct
Ereunetes	extinct
Ereunetes_rayi	extinct
Ergilornithidae	extinct
Erolia	extinct
Erolia_minutilla	extinct
Erolia_penepusilla	extinct
Eudocimus	extinct
Eudocimus_leiseyi	extinct
Eudocimus_peruvianus	extinct
Eudromia	extinct
Eudyptes	extinct
Eudyptes_pachyrhynchus	extant
Eudyptula_minor	extant
Euenantiornithes	extinct
Euphagus	extinct
Eurofluvioviridavis_robustipes	extinct
Eurotrochilus	extinct
Eurotrochilus_inexpectatus	extinct
Euryapteryx	extinct
Euryapteryx_geranoides	extant
Eutelornis_patagonicus	extinct
Eutreptodactylus_itaboraiensis	extinct
Evgenavis_nobilis	extinct
Explorornis_nessovi	extinct
Explorornis_walkeri	extinct
Falco	extinct
Falco_cenchroides	extant
Falco_falconella	extinct
Falco_mexicanus	extant
Falconidae	extinct
Falconiformes	extinct
Falco_novaeseelandiae	extinct
Falco_oregonus	extinct
Falco_pisanus	extinct
Falco_readi	extinct
Falco_sparverius	extant
Feitianius_paradisi	extinct
Fissuravis_weigelti	extinct
Flexomornis_howei	extinct
Fluviatilavis_antunesi	extinct
Fluvioviridavis	extinct
Fluvioviridavis_platyrhamphus	extinct
Foetopterus_ambiguus	extinct
Fortunguavis_xiaotaizicus	extinct
Foudia	extinct
Francolinus	extinct
Fratercula	extinct
Fratercula_arctica	extant
Fratercula_cirrhata	extant
Fratercula_corniculata	extant
Fratercula_dowi	extinct
Fraterculini	extinct
Fregata_ariel	extant
Fregata_minor	extant
Fringillidae	extinct
Fulica	extinct
Fulica_americana	extant
Fulica_infelix	extinct
Fulica_minor	extinct
Fulica_podagrica	extant
Fulica_prisca	extant
Fulmarinae	extinct
Fulmarus	extinct
Fulmarus_glacialis	extant
Fulmarus_hammeri	extinct
Fulmarus_miocaenus	extinct
Fumicollis_hoffmani	extinct
Galliformes	extinct
Gallinago	extinct
Gallinago_azovica	extinct
Gallinago_gallinago	extinct
Gallinula	extinct
Gallinula_brodkorbi	extinct
Gallinula_chloropus	extant
Gallinula_mortierii	extant
Gallinuloides	extinct
Gallirallus	extinct
Gallirallus_australis	extant
Galloanserae	extinct
Gallornis_straeleni	extinct
Gallus	extinct
Gallus_gallus	extant
Gansugyps_linxiaensis	extinct
Gansus_yumenensis	extinct
Gargantuavis_philoinos	extinct
Gastornis	extinct
Gastornis_parisiensis	extinct
Gastornis_russelli	extinct
Gavia	extinct
Gavia_arctica	extinct
Gavia_brodkorbi	extinct
Gavia_concinna	extinct
Gavia_egeriana	extinct
Gavia_fortis	extinct
Gavia_howardae	extinct
Gavia_immer	extant
Gaviidae	extinct
Gaviiformes	extinct
Genyornis	extinct
Geochen_rhuax	extant
Geranoaetus	extinct
Geranoaetus_contortus	extinct
Geranoides_jepseni	extinct
Geranoididae	extinct
Geranopterus_alatus	extinct
Geranopterus_milneedwardsi	extinct
Geronogyps_reliquus	extinct
Gigantornis	extinct
Gigantornis_eaglesomei	extinct
Glaucidium	extinct
Glaucidium_dickinsoni	extinct
Glaucidium_explorator	extinct
Glaucionetta	extinct
Glossopsitta_concinna	extant
Gobipipus_reshetovi	extinct
Gobipteryx	extinct
Gobipteryx_minuta	extinct
Goliathia_andrewsi	extinct
Grabauornis_lingyuanensis	extinct
Gracilitarsus_mirabilis	extinct
Gracilornis_jiufotangensis	extinct
Graculavidae	extinct
Graculavus	extinct
Graculavus_velox	extinct
Gradiornis_walbeckensis	extinct
Grallistrix_auceps	extant
Grallistrix_erdmani	extant
Grallistrix_geleches	extinct
Grallistrix_orion	extinct
Gruidae	extinct
Gruiformes	extinct
Grus	extinct
Grus_americana	extinct
Grus_antigone	extinct
Grus_canadensis	extant
Grus_grus	extant
Grus_marshi	extinct
Grus_nannodes	extinct
Grus_pratensis	extinct
Gurilynia_nessovi	extinct
Gygis_alba	extant
Gymnogyps	extinct
Gymnogyps_californianus	extinct
Gymnogyps_howardae	extinct
Gymnogyps_kofordi	extinct
Gypaetinae	extinct
Gypaetus_barbatus	extinct
Hadrogyps_aigialeus	extinct
Haematopus	extinct
Haematopus_finschi	extinct
Haematopus_ostralegus	extinct
Haematopus_palliatus	extinct
Haematopus_unicolor	extinct
Hakawai_melvillei	extinct
Halcyornithidae	extinct
Haliaeetus	extinct
Haliaeetus_albicilla	extant
Haliaeetus_leucocephalus	extant
Halimornis_thompsoni	extinct
Harpagornis	extinct
Harpagornis_moorei	extinct
Heliadornis_ashbyi	extinct
Helonetta_brodkorbi	extinct
Hemiphaga	extinct
Hemiphaga_novaeseelandiae	extant
Hesperornis	extinct
Hesperornis_crassipes	extinct
Hesperornis_gracilis	extinct
Hesperornis_montana	extinct
Hesperornis_regalis	extinct
Hesperornis_rossicus	extinct
Hesperornithidae	extinct
Hesperornithiformes	extinct
Heterostrix_tatsinensis	extinct
Himantopus	extinct
Hirundinidae	extinct
Hirundo	extinct
Hoazinoides_magdalenae	extinct
Hokkaidornis_abashiriensis	extinct
Holbotia_ponomarenkoi	extinct
Hollanda_luceria	extinct
Hongshanornis_longicresta	extinct
Horezmavis_eocretacea	extinct
Huoshanornis_huji	extinct
Hwangsanipes_choughi	extinct
Hydrobatidae	extinct
Hydrochelidon	extinct
Hylocichla	extinct
Hymenolaimus_malacorhynchos	extinct
Iaceornis_marshi	extinct
Iberomesornis	extinct
Iberomesornis_romerali	extinct
Icadyptes_salasi	extinct
Ichthyornis	extinct
Ichthyornis_dispar	extinct
Ichthyornis_maltshevskyi	extinct
Ichthyornis_minusculus	extinct
Ichthyornithiformes	extinct
Icterinae	extinct
Icterus	extinct
Idiornis_gaillardi	extinct
Ilbandornis	extinct
Ilerdopteryx_viai	extinct
Incolornis_martini	extinct
Incolornis_silvae	extinct
Inguza_predemersus	extinct
Inkayacu_paracasensis	extinct
Intiornis_inexpectatus	extinct
Itaboravis_elaphrocnemoides	extinct
Iteravis	extinct
Ixobrychus_exilis	extinct
Jabiru_mycteria	extinct
Jacana	extinct
Jacana_farrandi	extinct
Jacana_spinosa	extinct
Janipes_nymphaeobates	extinct
Jeholornis	extinct
Jeholornis_curvipes	extinct
Jeholornis_palmapenis	extinct
Jeholornis_prima	extinct
Jianchangornis_microdonta	extinct
Jibeinia_luanhera	extinct
Jiliniornis_huadianensis	extinct
Jindongornipes_kimi	extinct
Jinzhouornis_yixianensis	extinct
Jinzhouornis_zhangjiyingia	extinct
Jiuquanornis_niui	extinct
Jixiangornis_orientalis	extinct
Judinornis_nogontsavensis	extinct
Juehuaornis_zhangi	extinct
Juncitarsus_gracillimus	extinct
Junco	extinct
Junco_hyemalis	extinct
Jungornithidae	extinct
Kaiika_maxwelli	extinct
Kairuku	extinct
Kairuku_grebneffi	extinct
Kairuku_waitaki	extinct
Kelenken_guillermoi	extinct
Kizylkumavis_cretacea	extinct
Koreanaornis	extinct
Koreanaornis_hamanensis	extinct
Koreanornis_sinensis	extinct
Korora_oliveri	extinct
Kuiornis_indicator	extinct
Kuntur_cardenasi	extinct
Kuszholia	extinct
Kuszholia_mengi	extinct
Lagopterus_minutus	extinct
Lamarqueavis_australis	extinct
Lamarqueavis_minima	extinct
Lamarqueavis_petra	extinct
Laornis_edvardsianus	extinct
Largirostrornis	extinct
Laridae	extinct
Larus	extinct
Larus_argentatus	extinct
Larus_atricilla	extinct
Larus_californicus	extinct
Larus_delawarensis	extinct
Larus_dominicanus	extant
Larus_elmorei	extinct
Larus_lacus	extinct
Larus_minutus	extinct
Larus_novaehollandiae	extant
Larus_oregonus	extinct
Larus_perpetuus	extinct
Larus_pristinus	extinct
Larus_robustus	extinct
Laterallus	extinct
Laterallus_guti	extinct
Latipons	extinct
Latipons_gardneri	extinct
Lavocatavis_africana	extinct
Lectavis_bretincola	extinct
Leptopterus	extinct
Leptoptilos	extinct
Leptoptilos_dubius	extinct
Leptoptilos_falconeri	extinct
Leptoptilos_patagonicus	extinct
Leptoptilos_robustus	extinct
Leptoptilos_titan	extinct
Leucocarbo	extinct
Leucocarbo_carunculatus	extinct
Liaoningornis_longidigitris	extinct
Limenavis_patagonica	extinct
Limicolavis_pluvianella	extinct
Limnodromus	extinct
Limnodromus_scolopaceus	extinct
Limnofregata_azygosternon	extinct
Limosa	extinct
Limosa_vanrossemi	extinct
Linyiornis_amoena	extinct
Liptornis_hesternus	extinct
Lithoptila_abdounensis	extinct
Lithornis	extinct
Lithornis_celetius	extinct
Lithornis_plebius	extinct
Lithornis_promiscuus	extinct
Lithornis_vulturinus	extinct
Lithornithidae	extinct
Litoripes_medius	extinct
Lonchodytes_estesi	extinct
Longchengornis_sanyanensis	extinct
Longicrusavis_houi	extinct
Longipteryx	extinct
Longipteryx_chaoyangensis	extinct
Longirostravis_hani	extinct
Longusunguis_kurochkini	extinct
Lophodytes_cucullatus	extinct
Lophortyx	extinct
Lophortyx_shotwelli	extinct
Loxia	extinct
Loxia_curvirostra	extinct
Lutetodontopteryx_tethyensis	extinct
Macrodontopteryx_oweni	extinct
Madrynornis_mirandus	extinct
Mancalla	extinct
Mancalla_californiensis	extinct
Mancalla_cedrosensis	extinct
Mancalla_diegense	extinct
Mancalla_lucasi	extinct
Mancalla_vergrandis	extinct
Mancallinae	extinct
Manu_antiquus	extinct
Manuherikia_douglasi	extinct
Manuherikia_lacustrina	extinct
Manuherikia_minuta	extinct
Marambiornis_exilis	extinct
Marplesornis_novaezealandiae	extinct
Martinavis	extinct
Martinavis_cruzyensis	extinct
Martinavis_minor	extinct
Martinavis_saltariensis	extinct
Martinavis_vincei	extinct
Martinavis_whetstonei	extinct
Masillapodargus_longipes	extinct
Masillastega_rectirostris	extinct
Matanas_enrighti	extinct
Matuku_otagoense	extinct
Megaceryle_alcyon	extinct
Megadyptes_antipodes	extinct
Megadyptes_waitaha	extant
Megalapteryx	extinct
Megalodytes	extinct
Megapaloelodus	extinct
Megapaloelodus_connectens	extinct
Megapaloelodus_opsigonus	extinct
Melanerpes	extinct
Melanerpes_carolinus	extinct
Melanerpes_erythrocephalus	extinct
Melanitta	extinct
Melanitta_ceruttii	extinct
Melanitta_fusca	extant
Melanitta_nigra	extant
Melanitta_perspicillata	extinct
Meleagris	extinct
Meleagris_gallopavo	extant
Meleagris_richmondi	extinct
Meleagris_tridens	extinct
Melospiza	extinct
Melospiza_melodia	extant
Menura_tyawanoides	extinct
Mergini	extinct
Mergus	extinct
Mergus_australis	extinct
Mergus_merganser	extant
Mergus_serrator	extant
Mesembriornis_milneedwardsi	extinct
Mesetaornis	extinct
Mesetaornis_polaris	extinct
Messelastur_gratulator	extinct
Messelirrisor_grandis	extinct
Micrathene	extinct
Micropalama	extinct
Micropalama_chapmani	extinct
Microsula	extinct
Microsula_pygmaea	extinct
Milvago	extinct
Milvago_brodkorbi	extinct
Milvago_chimachima	extinct
Milvoides_kempi	extinct
Milvus	extinct
Miocepphus	extinct
Miocepphus_blowi	extinct
Miocepphus_bohaskai	extinct
Miocepphus_mcclungi	extinct
Miocepphus_mergulellus	extinct
Miocitta_galbreathi	extinct
Miohierax_stocki	extinct
Miomancalla_howardi	extinct
Miomancalla_wetmorei	extinct
Miophasianus	extinct
Miophasianus_medius	extinct
Miorallus	extinct
Miortyx_teres	extinct
Miosula	extinct
Miosula_media	extinct
Miotadorna_sanctibathansi	extinct
Mirafra	extinct
Miraquila_terrestris	extinct
Moho_braccatus	extant
Molothrus	extinct
Molothrus_ater	extinct
Mopsitta_tanta	extinct
Moris_reyana	extinct
Morus	extinct
Morus_atlanticus	extinct
Morus_avitus	extinct
Morus_humeralis	extinct
Morus_lompocanus	extinct
Morus_loxostylus	extinct
Morus_magnus	extinct
Morus_peninsularis	extinct
Morus_peruvianus	extinct
Morus_recentior	extinct
Morus_vagabundus	extinct
Motacillinae	extinct
Motmotidae	extinct
Mullerornis	extinct
Musophagidae	extinct
Mycteria	extinct
Mycteria_milleri	extinct
Mycteria_wetmorei	extinct
Mystiornis_cyrili	extinct
Namaortyx_sperrgebietensis	extinct
Namapsitta_praeruptorum	extinct
Nanantius	extinct
Nanantius_eos	extinct
Nannococcyx_psix	extant
Nannonetta_invisitata	extinct
Nanortyx_inexpectatus	extinct
Neanis_schucherti	extinct
Neilus_sansomae	extinct
Nelepsittacus_daphneleeae	extinct
Nelepsittacus_donmertoni	extinct
Nelepsittacus_minimus	extinct
Neocathartes_grallator	extinct
Neochen_barbadiana	extant
Neococcyx	extinct
Neogaeornis_wetzeli	extinct
Neognathae	extinct
Neophrontops	extinct
Neophrontops_americanus	extinct
Neophrontops_slaughteri	extinct
Neophrontops_vetustus	extinct
Neornithes	extinct
Nesillas	extinct
Nestor_meridionalis	extinct
Nestor_notabilis	extinct
Nettapus_eyrensis	extinct
Nettion	extinct
Nettion_bunkeri	extinct
Nettion_greeni	extinct
Nettion_ogallalae	extinct
Neuquenornis_volans	extinct
Noguerornis_gonzalezi	extinct
Nothura	extinct
Nucleornis_insolitus	extinct
Numenius	extinct
Numenius_borealis	extinct
Numenius_tahitiensis	extant
Numida	extinct
Nuntius_solitarius	extinct
Nupharanassa_bulotorum	extinct
Nupharanassa_tolutaria	extinct
Nyctanassa_violacea	extant
Nycticorax	extinct
Nycticorax_fidens	extinct
Nyroca	extinct
Oceanites	extinct
Oceanites_zaloscarthmus	extinct
Oceanodroma	extinct
Oceanodroma_castro	extant
Oceanodroma_homochroa	extinct
Oceanodroma_hubbsi	extinct
Ocyplonessa_shotwelli	extinct
Odontiphorinidae	extinct
Odontophoridae	extinct
Odontopteryx	extinct
Odontopteryx_toliapica	extinct
Ogygoptynx_wetmorei	extinct
Olar_buccinator	extinct
Oligocolius_brevitarsus	extinct
Oligosylphe	extinct
Omnivoropteryx_sinousaorum	extinct
Opisthodactylus_patagonicus	extinct
Oreortyx_picta	extinct
Ornimegalonyx_oteroi	extinct
Ornithothoraces	extinct
Ornithurae	extinct
Ortalis	extinct
Ortalis_pollicaris	extinct
Ortalis_tantala	extinct
Osteodontornis	extinct
Osteodontornis_orri	extinct
Otididae	extinct
Otis	extinct
Otogornis_genghisi	extinct
Otus	extinct
Otus_asio	extant
Otus_guildayi	extinct
Otus_providentiae	extinct
Oxyura_hulberti	extinct
Oxyura_jamaicensis	extinct
Oxyura_zapatanima	extinct
Pachycorioolithus_jinyunensis	extinct
Pachydyptes_ponderosus	extinct
Pachydyptes_simpsoni	extinct
Pachyornis	extinct
Pachyornis_elephantopus	extant
Pachyptila	extinct
Pachyptila_salax	extinct
Pachyptila_turtur	extinct
Pagophila	extinct
Palaeastur_atavus	extinct
Palaeeudyptes	extinct
Palaeeudyptes_antarcticus	extinct
Palaeeudyptes_gunnari	extinct
Palaeeudyptes_klekowskii	extinct
Palaeeudyptes_marplesi	extinct
Palaelodus	extinct
Palaelodus_aotearoa	extinct
Palaeoborus_rosatus	extinct
Palaeochenoides	extinct
Palaeociconia_australis	extinct
Palaeocrex_fax	extinct
Palaeocryptonyx	extinct
Palaeoephippiorhynchus_dietrichi	extinct
Palaeognathae	extinct
Palaeogyps_prodromus	extinct
Palaeonossax_senectus	extinct
Palaeophasianus_meleagroides	extinct
Palaeophoyx_columbiana	extinct
Palaeorallus_troxelli	extinct
Palaeortyx	extinct
Palaeortyx_gallica	extinct
Palaeortyx_intermedia	extinct
Palaeortyx_volans	extinct
Palaeospheniscus	extinct
Palaeospheniscus_affinis	extinct
Palaeospheniscus_bergi	extinct
Palaeospheniscus_bilocular	extinct
Palaeospheniscus_gracilis	extinct
Palaeospheniscus_huxleyorum	extinct
Palaeospheniscus_intermedius	extinct
Palaeospheniscus_interruptus	extinct
Palaeospheniscus_patagonicus	extinct
Palaeospheniscus_planus	extinct
Palaeospheniscus_rothi	extinct
Palaeospheniscus_wimani	extinct
Palaeospiza_bella	extinct
Palaeostruthus_eurius	extinct
Palaeotis_weigelti	extinct
Palaeotodus_itardiensis	extinct
Palaeotringa_littoralis	extinct
Palaeotringa_vagans	extinct
Paleopsilopterus_itaboraiensis	extinct
Paleosula_stocktoni	extinct
Palintropus	extinct
Panalcidae	extinct
Pandanaris_convexa	extinct
Pandion	extinct
Pandionidae	extinct
Pandion_lovensis	extinct
Pansphenisciformes	extinct
Papasula_abbotti	extant
Parabohaiornis_martini	extinct
Paracathartes_howardae	extinct
Paracrax_gigantea	extinct
Paracrax_wetmorei	extinct
Paractiornis_perpusillus	extinct
Paractitis	extinct
Paracygnopterus	extinct
Parahesperornis	extinct
Parahesperornis_alexi	extinct
Parahongshanornis_chaoyangensis	extinct
Paranyroca_magna	extinct
Paraortygometra	extinct
Paraortyx	extinct
Paraortyx_lorteti	extinct
Parapavo	extinct
Parapavo_californicus	extinct
Parapengornis_eurycaudatus	extinct
Paraprefica_kelleri	extinct
Paraprefica_major	extinct
Paraprotopteryx_gracilis	extinct
Paraptenodytes_antarcticus	extinct
Paraptenodytes_brodkorbi	extinct
Paraptenodytes_robustus	extinct
Parargornis_messelensis	extinct
Parulinae	extinct
Parus	extinct
Parvavis_chuxiongensis	extinct
Parvigrus_pohli	extinct
Parvirallus_gracilis	extinct
Pasquiaornis_hardiei	extinct
Pasquiaornis_tankei	extinct
Passer	extinct
Passerculus_sandwichensis	extinct
Passerella	extinct
Passerella_iliaca	extinct
Passeriformes	extinct
Passerina	extinct
Patagonichnornis_venetiorum	extinct
Patagopteryx_deferrariisi	extinct
Patagornis_marshi	extinct
Pavo_muticus	extinct
Pediohierax_ramenta	extinct
Pelagodroma	extinct
Pelagodroma_marina	extant
Pelagornis	extinct
Pelagornis_chilensis	extinct
Pelagornis_longirostris	extinct
Pelagornis_mauretanicus	extinct
Pelagornis_miocaenus	extinct
Pelagornis_sandersi	extinct
Pelagornis_stirtoni	extinct
Pelagornithidae	extinct
Pelecaniformes	extinct
Pelecanoides	extinct
Pelecanoides_cymatotrypetes	extinct
Pelecanoides_miokuaka	extinct
Pelecanoides_urinatrix	extinct
Pelecanus	extinct
Pelecanus_cadimurka	extant
Pelecanus_erythrorhynchos	extinct
Pelecanus_grandiceps	extinct
Pelecanus_halieus	extinct
Pelecanus_occidentalis	extinct
Pelecanus_odessanus	extinct
Pelecanus_proavus	extant
Pelecanus_schreiberi	extinct
Pelecanus_sivalensis	extinct
Pelecanus_tirarensis	extant
Pellornis_mikkelseni	extinct
Pengornis_houi	extinct
Perdicinae	extinct
Perisoreus_canadensis	extinct
Perplexicervix_microcephalon	extinct
Perudyptes_devriesi	extinct
Perugyps_diazi	extinct
Petralca_austriaca	extinct
Petrochelidon	extinct
Petrochelidon_pyrrhonota	extinct
Petroica	extinct
Petroica_australis	extant
Phaeornis_obscurus	extinct
Phaethon_aethereus	extant
Phaethon_lepturus	extant
Phaethontes	extinct
Phaethusavis_pelagicus	extinct
Phalacrocoracidae	extinct
Phalacrocorax	extinct
Phalacrocorax_auritus	extinct
Phalacrocorax_bougainvillii	extinct
Phalacrocorax_brasilianus	extinct
Phalacrocorax_carbo	extant
Phalacrocorax_chapalensis	extinct
Phalacrocorax_destefanii	extinct
Phalacrocorax_femoralis	extinct
Phalacrocorax_filyawi	extinct
Phalacrocorax_goletensis	extinct
Phalacrocorax_idahensis	extinct
Phalacrocorax_intermedius	extinct
Phalacrocorax_kennelli	extinct
Phalacrocorax_leptopus	extinct
Phalacrocorax_longipes	extinct
Phalacrocorax_macer	extinct
Phalacrocorax_macropus	extinct
Phalacrocorax_marinavis	extinct
Phalacrocorax_mediterraneus	extinct
Phalacrocorax_mongoliensis	extinct
Phalacrocorax_pelagicus	extant
Phalacrocorax_penicillatus	extinct
Phalacrocorax_reliquus	extinct
Phalacrocorax_rogersi	extinct
Phalacrocorax_varius	extinct
Phalacrocorax_wetmorei	extinct
Phalaropus	extinct
Phaps_chalcoptera	extant
Phaps_elegans	extant
Phasianidae	extinct
Phasmagyps_patritus	extinct
Philesturnus	extinct
Philesturnus_carunculatus	extinct
Phocavis_maritimus	extinct
Phoenicopteridae	extinct
Phoenicopterus	extinct
Phoenicopterus_copei	extinct
Phoenicopterus_floridanus	extinct
Phoenicopterus_stocki	extinct
Phorusrhacidae	extinct
Phorusrhacinae	extinct
Phorusrhacos_longissimus	extinct
Physornis	extinct
Pica	extinct
Pica_mourerae	extinct
Pica_pica	extinct
Pici	extinct
Picidae	extinct
Picoides_villosus	extinct
Pikaihao_bartlei	extinct
Pinguinus_alfrednewtoni	extinct
Pinguinus_impennis	extant
Pinicola	extinct
Pipilo	extinct
Piranga	extinct
Piranga_olivacea	extinct
Piscivoravis_lii	extinct
Plataleidae	extinct
Platycercus	extinct
Platycercus_elegans	extant
Platydyptes_amiesi	extinct
Platydyptes_marplesi	extinct
Platydyptes_novaezealandiae	extinct
Plegadis	extinct
Plegadis_chihi	extinct
Pleistorallus_flemingi	extinct
Plesiocathartes	extinct
Pliogallus	extinct
Pliogyps_charon	extinct
Pliogyps_fisheri	extinct
Plioperdix_hungarica	extinct
Pliopicus	extinct
Ploceus	extinct
Plotopteridae	extinct
Plotopterum	extinct
Plotopterum_joaquinensis	extinct
Plotornis_graculoides	extinct
Plotus_laticeps	extinct
Pluvialis	extinct
Pluvialis_dominica	extinct
Pluvialis_squatarola	extinct
Podiceps	extinct
Podiceps_arndti	extinct
Podiceps_auritus	extinct
Podiceps_caspicus	extinct
Podiceps_discors	extinct
Podiceps_dixi	extinct
Podiceps_sociatus	extinct
Podiceps_subparvus	extinct
Podicipedidae	extinct
Podilymbus	extinct
Podilymbus_podiceps	extant
Polarornis_gregorii	extinct
Porphyrio	extinct
Porphyrula	extinct
Porzana	extinct
Porzana_astrictocarpus	extant
Porzana_auffenbergi	extinct
Porzana_keplerorum	extant
Porzana_lacustris	extinct
Porzana_menehune	extant
Porzana_porzana	extinct
Porzana_ralphorum	extinct
Porzana_severnsi	extant
Porzana_ziegleri	extinct
Potamornis_skutchi	extinct
Presbychen_abavus	extinct
Presbyornis	extinct
Presbyornis_isoni	extinct
Presbyornis_mongoliensis	extinct
Presbyornis_pervetus	extinct
Presbyornis_recurvirostrus	extinct
Presbyornithidae	extinct
Primapus_lacki	extinct
Primobucco_frugilegus	extinct
Primobucco_kistneri	extinct
Primobucco_mcgrewi	extinct
Primobucco_perneri	extinct
Primocolius_sigei	extinct
Primotrogon	extinct
Primotrogon_pumilio	extinct
Primotrogon_wintersteini	extinct
Proapteryx_micromeros	extinct
Proardeola_walkeri	extinct
Probalearica_crataegensis	extinct
Procellaria	extinct
Procellaria_aequinoctialis	extinct
Procellaria_parkinsoni	extinct
Procellariidae	extinct
Procellariiformes	extinct
Procrax_brevipes	extinct
Progura	extinct
Promilio_brodkorbi	extinct
Promilio_efferus	extinct
Promilio_epileus	extinct
Promilio_floridanus	extinct
Proornis_coreae	extinct
Propelargus_olseni	extinct
Prophaethon	extinct
Prophaethontidae	extinct
Prophalacrocorax_ronzoni	extinct
Prosthemadera_novaeseelandiae	extant
Prosybris_antiqua	extinct
Protibis	extinct
Protocitta_ajax	extinct
Protocitta_dixi	extinct
Protocypselomorphus_manfredkelleri	extinct
Protomelanitta_bakeri	extinct
Protopelicanus_cuvierii	extinct
Protoplotus_beauforti	extinct
Protopteryx_fengningensis	extinct
Protorhea_azarae	extinct
Protostrigidae	extinct
Protostrix_californiensis	extinct
Protostrix_leptosteus	extinct
Protostrix_saurodosis	extinct
Pseudaptenodytes	extinct
Pseudaptenodytes_macraei	extinct
Pseudocepphus_teres	extinct
Pseudocrypturus_cercanaxius	extinct
Pseudodontornis_tenuirostris	extinct
Pseudospheniscus_concavus	extinct
Psilopteridae	extinct
Psilopterus_bachmanni	extinct
Psilopterus_colzecus	extinct
Psilopterus_lemoinei	extinct
Psittacidae	extinct
Psittaciformes	extinct
Ptaiochen_pau	extant
Pterodroma	extinct
Pterodroma_cahow	extant
Pterodroma_hypoleuca	extant
Pterodroma_inexpectata	extinct
Pterodroma_jugabilis	extinct
Pterodroma_lessonii	extinct
Pterodroma_phaeopygia	extinct
Pterodroma_rupinarum	extant
Pterodromoides_minoricensis	extinct
Ptilonorhynchus_violaceus	extant
Ptychoramphus_aleuticus	extant
Puffinus	extinct
Puffinus_barnesi	extinct
Puffinus_calhouni	extinct
Puffinus_conradi	extinct
Puffinus_diatomicus	extinct
Puffinus_felthami	extinct
Puffinus_gavia	extinct
Puffinus_gilmorei	extinct
Puffinus_gravis	extinct
Puffinus_griseus	extinct
Puffinus_holeae	extinct
Puffinus_inceptor	extinct
Puffinus_kanakoffi	extinct
Puffinus_lherminieri	extant
Puffinus_micraulax	extinct
Puffinus_mitchelli	extinct
Puffinus_nestori	extinct
Puffinus_opisthomelas	extinct
Puffinus_pacificoides	extinct
Puffinus_pacificus	extant
Puffinus_priscus	extinct
Puffinus_puffinus	extinct
Puffinus_spelaeus	extant
Puffinus_tedfordi	extinct
Puffinus_tenuirostris	extinct
Pullornipes_aureus	extinct
Pygoscelis	extinct
Pygoscelis_calderensis	extinct
Pygoscelis_grandis	extinct
Pygoscelis_papua	extant
Pygoscelis_tyreei	extinct
Pyrrhocorax	extinct
Pyrrhocorax_graculus	extinct
Qianshanornis_rapax	extinct
Qiliania_graffini	extinct
Qinornis_paleocenica	extinct
Quercyrallus_ludianus	extinct
Querquedula	extinct
Querquedula_floridiana	extinct
Querquedula_integra	extinct
Querquedula_pullulans	extinct
Quiscalus	extinct
Quiscalus_major	extinct
Quiscalus_mexicanus	extinct
Quiscalus_quiscula	extinct
Rahonavis_ostromi	extinct
Rallidae	extinct
Rallinae	extinct
Rallus	extinct
Rallus_elegans	extinct
Rallus_hodgeni	extinct
Rallus_limicola	extinct
Rallus_longirostris	extant
Rallus_philippensis	extant
Rallus_recessus	extinct
Ramphastosula_aguierrei	extinct
Ramphastosula_ramirezi	extinct
Rapaxavis_pani	extinct
Raphus_cucullatus	extant
Ratitae	extinct
Recurvirostra	extinct
Remiornis	extinct
Remiornis_heberti	extinct
Rhea	extinct
Rhea_americana	extant
Rhea_fossilis	extinct
Rhea_pampeana	extinct
Rhea_subpampeana	extinct
Rhegminornis_calobates	extinct
Rheidae	extinct
Rhipidura_fuliginosa	extant
Rhynchaeites_messelensis	extinct
Rissa	extinct
Rissa_estesi	extinct
Rissa_tridactyla	extant
Romainvillia	extinct
Romainvilliinae	extinct
Rupelramphastoides_knopfi	extinct
Rupephaps_taketake	extinct
Samrukia_nessovi	extinct
Sapeornis_chaoyangensis	extinct
Sarcoramphus_fischeri	extinct
Sarcorhamphus_fossilis	extinct
Sarjeantopodus_semipalmatus	extinct
Sarmatosula_dobrogensis	extinct
Sayornis_phoebe	extinct
Sazavis_prisca	extinct
Sceloglaux_albifacies	extant
Schizooura_lii	extinct
Scolecophagus_affinis	extinct
Scolopaci	extinct
Scolopacidae	extinct
Scolopax	extinct
Scolopax_hutchensi	extinct
Scolopax_minor	extinct
Scopelortyx_klinghardtensis	extinct
Scopus	extinct
Septentrogon_madseni	extinct
Shandongornipes_muxiai	extinct
Shanweiniao_cooperorum	extinct
Shengjingornis_yangi	extinct
Shenqiornis_mengi	extinct
Shenzhouraptor_sinensis	extinct
Shiriyanetta_hasegawai	extinct
Sinanas	extinct
Sinornis_santensis	extinct
Sitta	extinct
Sitta_canadensis	extinct
Somateria	extinct
Somateria_mollissima	extant
Songlingornis_linghensis	extinct
Songzia_heidangkouensis	extinct
Soroavisaurus_australis	extinct
Spatula	extinct
Speotyto_cunicularia	extinct
Spheniscidae	extinct
Sphenisciformes	extinct
Spheniscus	extinct
Spheniscus_chilensis	extinct
Spheniscus_demersus	extant
Spheniscus_megaramphus	extinct
Spheniscus_muizoni	extinct
Spheniscus_urbinai	extinct
Spizaetus	extinct
Spizaetus_tanneri	extinct
Spizella	extinct
Spizella_pusilla	extinct
Steatornithidae	extinct
Steganopus	extinct
Stemec_suntokum	extinct
Stercorarius	extinct
Stercorarius_longicaudus	extinct
Stercorarius_parasiticus	extinct
Stercorarius_pomarinus	extinct
Sterna	extinct
Sterna_fuscata	extant
Sterna_maxima	extinct
Sterna_nilotica	extinct
Stictocarbo_kumeyaay	extinct
Stictocarbo_punctatus	extinct
Streptopelia	extinct
Strigidae	extinct
Strigiformes	extinct
Strigops	extinct
Strix	extinct
Strix_brevis	extinct
Strix_dakota	extinct
Strix_varia	extinct
Struthio	extinct
Struthio_asiaticus	extinct
Struthio_camelus	extant
Struthio_chersonensis	extinct
Struthionidae	extinct
Sturnella	extinct
Sturnus	extinct
Sula	extinct
Sula_brandi	extinct
Sula_clarki	extinct
Sula_dactylatra	extant
Sula_figueroae	extinct
Sula_magna	extinct
Sula_pohli	extinct
Sula_sula	extant
Sula_sulita	extinct
Sula_universitatis	extinct
Sula_willetti	extinct
Sulcavis_geeorum	extinct
Sulidae	extinct
Surnia	extinct
Sylviidae	extinct
Synthliboramphus	extinct
Synthliboramphus_antiquus	extant
Synthliboramphus_hypoleucus	extinct
Synthliboramphus_rineyi	extinct
Syrigma_sanctimartini	extinct
Tachybaptus	extinct
Tachybaptus_dominicus	extinct
Tachycineta	extinct
Tachycineta_speleodytes	extinct
Tadorna	extinct
Tadorna_tadornoides	extinct
Tadorna_variegata	extinct
Taoperdix	extinct
Tatarornipes_chabuensis	extinct
Taubatornis_campbelli	extinct
Telecrex_grangeri	extinct
Telmabates_antiquus	extinct
Telmabates_howardae	extinct
Telmatornis_priscus	extinct
Teratornis_merriami	extant
Tereingaornis_moisleyi	extinct
Terpsiphone	extinct
Teviornis_gobiensis	extinct
Thalassarche	extinct
Thalassarche_bulleri	extinct
Thambetochen	extinct
Thambetochen_chauliodous	extinct
Thambetochen_xanion	extinct
Thamnornis	extinct
Thegornis_debilis	extinct
Theristicus_wetmorei	extinct
Thinocoridae	extinct
Thinocorus	extinct
Thinocorus_koepckae	extinct
Thomasococcyx_philohippus	extinct
Threskiornithidae	extinct
Threskiornithinae	extinct
Tianyuornis_cheni	extinct
Tigrisoma	extinct
Tinamidae	extinct
Tinamisornis_intermedius	extinct
Tinamisornis_parvulus	extinct
Titanis_walleri	extinct
Tonniornis_mesetaensis	extinct
Tonniornis_minimum	extinct
Tonsala_buchanani	extinct
Tonsala_hildegardae	extinct
Torotix_clemensi	extinct
Totanus	extinct
Toxostoma	extinct
Toxostoma_rufum	extinct
Treleudytes_crassa	extinct
Tringa	extinct
Tringa_ameghini	extinct
Tringa_fuscicollis	extinct
Tringa_ochropus	extinct
Tringinae	extinct
Troglodytes	extinct
Tshulia_litorea	extinct
Turdinae	extinct
Turdus	extinct
Turdus_migratorius	extant
Turnagra_capensis	extant
Turnipax_oechslerorum	extinct
Turnix	extinct
Turnix_varia	extant
Tympanonesiotes_wetmorei	extinct
Tympanuchus	extinct
Tympanuchus_cupido	extinct
Tympanuchus_lulli	extinct
Tympanuchus_pallidicinctus	extinct
Tympanuchus_stirtoni	extinct
Tyto	extinct
Tyto_alba	extant
Tyto_balearica	extinct
Tyto_mourerchauvireae	extinct
Tytthostonyx_glauconiticus	extinct
Uhangrichnus_chuni	extinct
Uintornis_lucaris	extinct
Uintornis_marionae	extinct
Upupa	extinct
Upupa_antaios	extinct
Uria	extinct
Uria_aalge	extant
Uria_affinis	extinct
Uria_brodkorbi	extinct
Uria_lomvia	extant
Uria_paleohesperis	extinct
Urubitinga_enecta	extinct
Vanga	extinct
Vastanavis	extinct
Vastanavis_eocaena	extinct
Vegavis_iaai	extinct
Vermivora	extinct
Vermivora_celata	extinct
Vescornis_hebeiensis	extinct
Viator_picis	extinct
Volgavis_marina	extinct
Vorona_berivotrensis	extinct
Vultur	extinct
Vultur_gryphus	extinct
Waimanu_manneringi	extinct
Waimanu_tuatahi	extinct
Walbeckornis	extinct
Walbeckornis_creber	extinct
Wanshuina_lii	extinct
Wieslochia_weissi	extinct
Wilaru_prideauxi	extinct
Wilaru_tedfordi	extinct
Wimanornis_seymourensis	extinct
Xanthocephalus_xanthocephalus	extinct
Xema	extinct
Xenerodiops_mycter	extinct
Xiangornis_shenmi	extinct
Xinghaiornis_lini	extinct
Yacoraitichnus_avis	extinct
Yandangornis_longicaudus	extinct
Yanornis_guozhangi	extinct
Yanornis_martini	extinct
Yixianornis_grabaui	extinct
Youngornis	extinct
Yuanjiawaornis_viriosus	extinct
Yumenornis_huangi	extinct
Yungavolucris_brevipedalis	extinct
Zenaida	extinct
Zenaida_macroura	extant
Zheroia_kurochkini	extinct
Zhongjianornis_yangi	extinct
Zhouornis_hani	extinct
Zhylgaia_aestiflua	extinct
Zhyraornis_logunovi	extinct
Zonotrichia	extinct
Zonotrichia_albicollis	extinct
Zonotrichia_leucophrys	extinct
Zosterops	extinct
Zygodactylus_ignotus	extinct
Zygodactylus_luberonensis	extinct
